YYYYYYYYYYYYYYYYYYYYYvvv^^^YYYYYYYYYYYYYYYYYYYYYYYYYYYYYYYYvvv^^^YYYYYYYYYYYYYYYYYYYYYY
YYYYYYYYYYYYYYYYYYYYYvvv^^^YYYYYYYYYYYYYYYYYYYYYYYYYYYYYYYYvvv^^^YYYYYYYYYYYYYYYYYYYYYY
YYYYYYYYYYYYYYYYYYYYYvvv^^^YYYYYYYYYYYYYYYYYYYYYYYYYYYYYYYYvvv^^^YYYYYYYYYYYYYYYYYYYYYY
YYYYYYYYYYYYYYYYYYYYYvvv^^^YYYYYYYYYYYYYYYYYYYYYYYYYYYYYYYYvvv^^^YYYYYYYYYYYYYYYYYYYYYY
YYYYYYYYYYYYYYYYYYYYYvvv^^^YYYYYYYYYYYYYYYYYYYYYYYYYYYYYYYYvvv^^^YYYYYYYYYYYYYYYYYYYYYY
YYYYYYYYYYYYYYYYYYYYYvvv^^^YYYYYYYYYYYYYYYYYYYYYYYYYYYYYYYYvvv^^^YYYYYYYYYYYYYYYYYYYYYY
YYYYYYYYYYYYYYYYYYYYYvvv^^^YYYYYYYYYYYYYYYYYYYYYYYYYYYYYYYYvvv^^^YYYYYYYYYYYYYYYYYYYYYY
YYYYYYYYYYYYYYYYYYYYYvvv^^^YYYYYYYYYYYYYYYYYYYYYYYYYYYYYYYYvvv^^^YYYYYYYYYYYYYYYYYYYYYY
YYYYYYYYYYYYYYYYYYYYYvvv^^^YYYYYYYYYYYYYYYYYYYYYYYYYYYYYYYYvvv^^^YYYYYYYYYYYYYYYYYYYYYY
YYYYYYYYYYYYYYYYYYYYZvvvDDDYYYYYYYYYYYYYYYYYYYYYYYYYYYYYYYZvvvHHHYYYYYYYYYYYYYYYYYYYYYY
<<<<<<<<<<<<<<<<<<<<A++++++<<<<<<<<<<<<<<<<<<<<<<<<<<<<<<<E++++++<<<<<<<<<<<<<<<<<<<<<<
<<<<<<<<<<<<<<<<<<<<A++++++<<<<<<<<<<<<<<<<<<<<<<<<<<<<<<<E++++++<<<<<<<<<<<<<<<<<<<<<<
<<<<<<<<<<<<<<<<<<<<A++++++<<<<<<<<<<<<<<<<<<<<<<<<<<<<<<<E++++++<<<<<<<<<<<<<<<<<<<<<<
>>>>>>>>>>>>>>>>>>>>>++++++F>>>>>>>>>>>>>>>>>>>>>>>>>>>>>>>++++++J>>>>>>>>>>>>>>>>>>>>>
>>>>>>>>>>>>>>>>>>>>>++++++F>>>>>>>>>>>>>>>>>>>>>>>>>>>>>>>++++++J>>>>>>>>>>>>>>>>>>>>>
>>>>>>>>>>>>>>>>>>>>>++++++F>>>>>>>>>>>>>>>>>>>>>>>>>>>>>>>++++++J>>>>>>>>>>>>>>>>>>>>>
YYYYYYYYYYYYYYYYYYYYYKKK^^^YYYYYYYYYYYYYYYYYYYYYYYYYYYYYYYYMMM^^^YYYYYYYYYYYYYYYYYYYYYY
YYYYYYYYYYYYYYYYYYYYYvvv^^^YYYYYYYYYYYYYYYYYYYYYYYYYYYYYYYYvvv^^^YYYYYYYYYYYYYYYYYYYYYY
YYYYYYYYYYYYYYYYYYYYYvvv^^^YYYYYYYYYYYYYYYYYYYYYYYYYYYYYYYYvvv^^^YYYYYYYYYYYYYYYYYYYYYY
YYYYYYYYYYYYYYYYYYYYYvvv^^^YYYYYYYYYYYYYYYYYYYYYYYYYYYYYYYYvvv^^^YYYYYYYYYYYYYYYYYYYYYY
YYYYYYYYYYYYYYYYYYYYYvvv^^^YYYYYYYYYYYYYYYYYYYYYYYYYYYYYYYYvvv^^^YYYYYYYYYYYYYYYYYYYYYY
YYYYYYYYYYYYYYYYYYYYYvvv^^^YYYYYYYYYYYYYYYYYYYYYYYYYYYYYYYYvvv^^^YYYYYYYYYYYYYYYYYYYYYY
YYYYYYYYYYYYYYYYYYYYYvvv^^^YYYYYYYYYYYYYYYYYYYYYYYYYYYYYYYYvvv^^^YYYYYYYYYYYYYYYYYYYYYY
YYYYYYYYYYYYYYYYYYYYYvvv^^^YYYYYYYYYYYYYYYYYYYYYYYYYYYYYYYYvvv^^^YYYYYYYYYYYYYYYYYYYYYY
YYYYYYYYYYYYYYYYYYYYYvvv^^^YYYYYYYYYYYYYYYYYYYYYYYYYYYYYYYYvvv^^^YYYYYYYYYYYYYYYYYYYYYY
YYYYYYYYYYYYYYYYYYYYZvvvLLLYYYYYYYYYYYYYYYYYYYYYYYYYYYYYYYZvvvNNNYYYYYYYYYYYYYYYYYYYYYY
<<<<<<<<<<<<<<<<<<<<O++++++<<<<<<<<<<<<<<<<<<<<<<<<<<<<<<<S++++++<<<<<<<<<<<<<<<<<<<<<<
<<<<<<<<<<<<<<<<<<<<O++++++<<<<<<<<<<<<<<<<<<<<<<<<<<<<<<<S++++++<<<<<<<<<<<<<<<<<<<<<<
<<<<<<<<<<<<<<<<<<<<O++++++<<<<<<<<<<<<<<<<<<<<<<<<<<<<<<<S++++++<<<<<<<<<<<<<<<<<<<<<<
>>>>>>>>>>>>>>>>>>>>>++++++T>>>>>>>>>>>>>>>>>>>>>>>>>>>>>>>++++++X>>>>>>>>>>>>>>>>>>>>>
>>>>>>>>>>>>>>>>>>>>>++++++T>>>>>>>>>>>>>>>>>>>>>>>>>>>>>>>++++++X>>>>>>>>>>>>>>>>>>>>>
>>>>>>>>>>>>>>>>>>>>>++++++T>>>>>>>>>>>>>>>>>>>>>>>>>>>>>>>++++++X>>>>>>>>>>>>>>>>>>>>>
YYYYYYYYYYYYYYYYYYYYYQQQ^^^YYYYYYYYYYYYYYYYYYYYYYYYYYYYYYYYUUU^^^YYYYYYYYYYYYYYYYYYYYYY
YYYYYYYYYYYYYYYYYYYYYvvv^^^YYYYYYYYYYYYYYYYYYYYYYYYYYYYYYYYvvv^^^YYYYYYYYYYYYYYYYYYYYYY
YYYYYYYYYYYYYYYYYYYYYvvv^^^YYYYYYYYYYYYYYYYYYYYYYYYYYYYYYYYvvv^^^YYYYYYYYYYYYYYYYYYYYYY
YYYYYYYYYYYYYYYYYYYYYvvv^^^YYYYYYYYYYYYYYYYYYYYYYYYYYYYYYYYvvv^^^YYYYYYYYYYYYYYYYYYYYYY
YYYYYYYYYYYYYYYYYYYYYvvv^^^YYYYYYYYYYYYYYYYYYYYYYYYYYYYYYYYvvv^^^YYYYYYYYYYYYYYYYYYYYYY
YYYYYYYYYYYYYYYYYYYYYvvv^^^YYYYYYYYYYYYYYYYYYYYYYYYYYYYYYYYvvv^^^YYYYYYYYYYYYYYYYYYYYYY
YYYYYYYYYYYYYYYYYYYYYvvv^^^YYYYYYYYYYYYYYYYYYYYYYYYYYYYYYYYvvv^^^YYYYYYYYYYYYYYYYYYYYYY
YYYYYYYYYYYYYYYYYYYYYvvv^^^YYYYYYYYYYYYYYYYYYYYYYYYYYYYYYYYvvv^^^YYYYYYYYYYYYYYYYYYYYYY
YYYYYYYYYYYYYYYYYYYYYvvv^^^YYYYYYYYYYYYYYYYYYYYYYYYYYYYYYYYvvv^^^YYYYYYYYYYYYYYYYYYYYYY
YYYYYYYYYYYYYYYYYYYYYvvv^^^YYYYYYYYYYYYYYYYYYYYYYYYYYYYYYYYvvv^^^YYYYYYYYYYYYYYYYYYYYYY