XXXXXXXXXXXXXXXXXXXXXvvv^^^XXXXXXXXXXXXXXXXXXXXXXXXXXXXXXXXvvv^^^XXXXXXXXXXXXXXXXXXXXXX
XXXXXXXXXXXXXXXXXXXXXvvv^^^XXXXXXXXXXXXXXXXXXXXXXXXXXXXXXXXvvv^^^XXXXXXXXXXXXXXXXXXXXXX
XXXXXXXXXXXXXXXXXXXXXvvv^^^XXXXXXXXXXXXXXXXXXXXXXXXXXXXXXXXvvv^^^XXXXXXXXXXXXXXXXXXXXXX
XXXXXXXXXXXXXXXXXXXXXvvv^^^XXXXXXXXXXXXXXXXXXXXXXXXXXXXXXXXvvv^^^XXXXXXXXXXXXXXXXXXXXXX
XXXXXXXXXXXXXXXXXXXXXvvv^^^XXXXXXXXXXXXXXXXXXXXXXXXXXXXXXXXvvv^^^XXXXXXXXXXXXXXXXXXXXXX
XXXXXXXXXXXXXXXXXXXXXvvv^^^XXXXXXXXXXXXXXXXXXXXXXXXXXXXXXXXvvv^^^XXXXXXXXXXXXXXXXXXXXXX
XXXXXXXXXXXXXXXXXXXXXvvv^^^XXXXXXXXXXXXXXXXXXXXXXXXXXXXXXXXvvv^^^XXXXXXXXXXXXXXXXXXXXXX
XXXXXXXXXXXXXXXXXXXXXvvv^^^XXXXXXXXXXXXXXXXXXXXXXXXXXXXXXXXvvv^^^XXXXXXXXXXXXXXXXXXXXXX
XXXXXXXXXXXXXXXXXXXXXvvv^^^XXXXXXXXXXXXXXXXXXXXXXXXXXXXXXXXvvv^^^XXXXXXXXXXXXXXXXXXXXXX
XXXXXXXXXXXXXXXXXXXXSvvv^^^XXXXXXXXXXXXXXXXXXXXXXXXXXXXXXXSvvv^^^XXXXXXXXXXXXXXXXXXXXXX
<<<<<<<<<<<<<<<<<<<<<++++++<<<<<<<<<<<<<<<<<<<<<<<<<<<<<<<<++++++<<<<<<<<<<<<<<<<<<<<<<
<<<<<<<<<<<<<<<<<<<<<++++++<<<<<<<<<<<<<<<<<<<<<<<<<<<<<<<<++++++<<<<<<<<<<<<<<<<<<<<<<
<<<<<<<<<<<<<<<<<<<<<++++++<<<<<<<<<<<<<<<<<<<<<<<<<<<<<<<<++++++<<<<<<<<<<<<<<<<<<<<<<
>>>>>>>>>>>>>>>>>>>>>++++++>>>>>>>>>>>>>>>>>>>>>>>>>>>>>>>>++++++>>>>>>>>>>>>>>>>>>>>>>
>>>>>>>>>>>>>>>>>>>>>++++++>>>>>>>>>>>>>>>>>>>>>>>>>>>>>>>>++++++>>>>>>>>>>>>>>>>>>>>>>
>>>>>>>>>>>>>>>>>>>>>++++++>>>>>>>>>>>>>>>>>>>>>>>>>>>>>>>>++++++>>>>>>>>>>>>>>>>>>>>>>
XXXXXXXXXXXXXXXXXXXXXvvv^^^XXXXXXXXXXXXXXXXXXXXXXXXXXXXXXXXvvv^^^XXXXXXXXXXXXXXXXXXXXXX
XXXXXXXXXXXXXXXXXXXXXvvv^^^XXXXXXXXXXXXXXXXXXXXXXXXXXXXXXXXvvv^^^XXXXXXXXXXXXXXXXXXXXXX
XXXXXXXXXXXXXXXXXXXXXvvv^^^XXXXXXXXXXXXXXXXXXXXXXXXXXXXXXXXvvv^^^XXXXXXXXXXXXXXXXXXXXXX
XXXXXXXXXXXXXXXXXXXXXvvv^^^XXXXXXXXXXXXXXXXXXXXXXXXXXXXXXXXvvv^^^XXXXXXXXXXXXXXXXXXXXXX
XXXXXXXXXXXXXXXXXXXXXvvv^^^XXXXXXXXXXXXXXXXXXXXXXXXXXXXXXXXvvv^^^XXXXXXXXXXXXXXXXXXXXXX
XXXXXXXXXXXXXXXXXXXXXvvv^^^XXXXXXXXXXXXXXXXXXXXXXXXXXXXXXXXvvv^^^XXXXXXXXXXXXXXXXXXXXXX
XXXXXXXXXXXXXXXXXXXXXvvv^^^XXXXXXXXXXXXXXXXXXXXXXXXXXXXXXXXvvv^^^XXXXXXXXXXXXXXXXXXXXXX
XXXXXXXXXXXXXXXXXXXXXvvv^^^XXXXXXXXXXXXXXXXXXXXXXXXXXXXXXXXvvv^^^XXXXXXXXXXXXXXXXXXXXXX
XXXXXXXXXXXXXXXXXXXXXvvv^^^XXXXXXXXXXXXXXXXXXXXXXXXXXXXXXXXvvv^^^XXXXXXXXXXXXXXXXXXXXXX
XXXXXXXXXXXXXXXXXXXXSvvv^^^XXXXXXXXXXXXXXXXXXXXXXXXXXXXXXXSvvv^^^XXXXXXXXXXXXXXXXXXXXXX
<<<<<<<<<<<<<<<<<<<<<++++++<<<<<<<<<<<<<<<<<<<<<<<<<<<<<<<<++++++<<<<<<<<<<<<<<<<<<<<<<
<<<<<<<<<<<<<<<<<<<<<++++++<<<<<<<<<<<<<<<<<<<<<<<<<<<<<<<<++++++<<<<<<<<<<<<<<<<<<<<<<
<<<<<<<<<<<<<<<<<<<<<++++++<<<<<<<<<<<<<<<<<<<<<<<<<<<<<<<<++++++<<<<<<<<<<<<<<<<<<<<<<
>>>>>>>>>>>>>>>>>>>>>++++++>>>>>>>>>>>>>>>>>>>>>>>>>>>>>>>>++++++>>>>>>>>>>>>>>>>>>>>>>
>>>>>>>>>>>>>>>>>>>>>++++++>>>>>>>>>>>>>>>>>>>>>>>>>>>>>>>>++++++>>>>>>>>>>>>>>>>>>>>>>
>>>>>>>>>>>>>>>>>>>>>++++++>>>>>>>>>>>>>>>>>>>>>>>>>>>>>>>>++++++>>>>>>>>>>>>>>>>>>>>>>
XXXXXXXXXXXXXXXXXXXXXvvv^^^XXXXXXXXXXXXXXXXXXXXXXXXXXXXXXXXvvv^^^XXXXXXXXXXXXXXXXXXXXXX
XXXXXXXXXXXXXXXXXXXXXvvv^^^XXXXXXXXXXXXXXXXXXXXXXXXXXXXXXXXvvv^^^XXXXXXXXXXXXXXXXXXXXXX
XXXXXXXXXXXXXXXXXXXXXvvv^^^XXXXXXXXXXXXXXXXXXXXXXXXXXXXXXXXvvv^^^XXXXXXXXXXXXXXXXXXXXXX
XXXXXXXXXXXXXXXXXXXXXvvv^^^XXXXXXXXXXXXXXXXXXXXXXXXXXXXXXXXvvv^^^XXXXXXXXXXXXXXXXXXXXXX
XXXXXXXXXXXXXXXXXXXXXvvv^^^XXXXXXXXXXXXXXXXXXXXXXXXXXXXXXXXvvv^^^XXXXXXXXXXXXXXXXXXXXXX
XXXXXXXXXXXXXXXXXXXXXvvv^^^XXXXXXXXXXXXXXXXXXXXXXXXXXXXXXXXvvv^^^XXXXXXXXXXXXXXXXXXXXXX
XXXXXXXXXXXXXXXXXXXXXvvv^^^XXXXXXXXXXXXXXXXXXXXXXXXXXXXXXXXvvv^^^XXXXXXXXXXXXXXXXXXXXXX
XXXXXXXXXXXXXXXXXXXXXvvv^^^XXXXXXXXXXXXXXXXXXXXXXXXXXXXXXXXvvv^^^XXXXXXXXXXXXXXXXXXXXXX
XXXXXXXXXXXXXXXXXXXXXvvv^^^XXXXXXXXXXXXXXXXXXXXXXXXXXXXXXXXvvv^^^XXXXXXXXXXXXXXXXXXXXXX
XXXXXXXXXXXXXXXXXXXXXvvv^^^XXXXXXXXXXXXXXXXXXXXXXXXXXXXXXXXvvv^^^XXXXXXXXXXXXXXXXXXXXXX