XXXXXXXXXXXXXXXXXXXXXvvv^^^XXXXXXXXXXXXXXXXXXXXXXXXXXXXXXXXvvv^^^XXXXXXXXXXXXXXXXXXXXXX
XXXXXXXXXXXXXXXXXXXXXvvv^^^XXXXXXXXXXXXXXXXXXXXXXXXXXXXXXXXvvv^^^XXXXXXXXXXXXXXXXXXXXXX
XXXXXXXXXXXXXXXXXXXXXvvv^^^XXXXXXXXXXXXXXXXXXXXXXXXXXXXXXXXvvv^^^XXXXXXXXXXXXXXXXXXXXXX
XXXXXXXXXXXXXXXXXXXXXvvv^^^XXXXXXXXXXXXXXXXXXXXXXXXXXXXXXXXvvv^^^XXXXXXXXXXXXXXXXXXXXXX
XXXXXXXXXXXXXXXXXXXXXvvv^^^XXXXXXXXXXXXXXXXXXXXXXXXXXXXXXXXvvv^^^XXXXXXXXXXXXXXXXXXXXXX
XXXXXXXXXXXXXXXXXXXXXvvv^^^XXXXXXXXXXXXXXXXXXXXXXXXXXXXXXXXvvv^^^XXXXXXXXXXXXXXXXXXXXXX
XXXXXXXXXXXXXXXXXXXXXvvv^^^XXXXXXXXXXXXXXXXXXXXXXXXXXXXXXXXvvv^^^XXXXXXXXXXXXXXXXXXXXXX
XXXXXXXXXXXXXXXXXXXXXvvv^^^XXXXXXXXXXXXXXXXXXXXXXXXXXXXXXXXvvv^^^XXXXXXXXXXXXXXXXXXXXXX
XXXXXXXXXXXXXXXXXXXXXvvv^^^XXXXXXXXXXXXXXXXXXXXXXXXXXXXXXXXvvv^^^XXXXXXXXXXXXXXXXXXXXXX
XXXXXXXXXXXXXXXXXXXXSvvvBBBXXXXXXXXXXXXXXXXXXXXXXXXXXXXXXXSvvvDDDXXXXXXXXXXXXXXXXXXXXXX
<<<<<<<<<<<<<<<<<<<<A++++++<<<<<<<<<<<<<<<<<<<<<<<<<<<<<<<C++++++<<<<<<<<<<<<<<<<<<<<<<
<<<<<<<<<<<<<<<<<<<<A++++++<<<<<<<<<<<<<<<<<<<<<<<<<<<<<<<C++++++<<<<<<<<<<<<<<<<<<<<<<
<<<<<<<<<<<<<<<<<<<<A++++++<<<<<<<<<<<<<<<<<<<<<<<<<<<<<<<C++++++<<<<<<<<<<<<<<<<<<<<<<
>>>>>>>>>>>>>>>>>>>>>++++++C>>>>>>>>>>>>>>>>>>>>>>>>>>>>>>>++++++E>>>>>>>>>>>>>>>>>>>>>
>>>>>>>>>>>>>>>>>>>>>++++++C>>>>>>>>>>>>>>>>>>>>>>>>>>>>>>>++++++E>>>>>>>>>>>>>>>>>>>>>
>>>>>>>>>>>>>>>>>>>>>++++++C>>>>>>>>>>>>>>>>>>>>>>>>>>>>>>>++++++E>>>>>>>>>>>>>>>>>>>>>
XXXXXXXXXXXXXXXXXXXXXFFF^^^XXXXXXXXXXXXXXXXXXXXXXXXXXXXXXXXGGG^^^XXXXXXXXXXXXXXXXXXXXXX
XXXXXXXXXXXXXXXXXXXXXvvv^^^XXXXXXXXXXXXXXXXXXXXXXXXXXXXXXXXvvv^^^XXXXXXXXXXXXXXXXXXXXXX
XXXXXXXXXXXXXXXXXXXXXvvv^^^XXXXXXXXXXXXXXXXXXXXXXXXXXXXXXXXvvv^^^XXXXXXXXXXXXXXXXXXXXXX
XXXXXXXXXXXXXXXXXXXXXvvv^^^XXXXXXXXXXXXXXXXXXXXXXXXXXXXXXXXvvv^^^XXXXXXXXXXXXXXXXXXXXXX
XXXXXXXXXXXXXXXXXXXXXvvv^^^XXXXXXXXXXXXXXXXXXXXXXXXXXXXXXXXvvv^^^XXXXXXXXXXXXXXXXXXXXXX
XXXXXXXXXXXXXXXXXXXXXvvv^^^XXXXXXXXXXXXXXXXXXXXXXXXXXXXXXXXvvv^^^XXXXXXXXXXXXXXXXXXXXXX
XXXXXXXXXXXXXXXXXXXXXvvv^^^XXXXXXXXXXXXXXXXXXXXXXXXXXXXXXXXvvv^^^XXXXXXXXXXXXXXXXXXXXXX
XXXXXXXXXXXXXXXXXXXXXvvv^^^XXXXXXXXXXXXXXXXXXXXXXXXXXXXXXXXvvv^^^XXXXXXXXXXXXXXXXXXXXXX
XXXXXXXXXXXXXXXXXXXXXvvv^^^XXXXXXXXXXXXXXXXXXXXXXXXXXXXXXXXvvv^^^XXXXXXXXXXXXXXXXXXXXXX
XXXXXXXXXXXXXXXXXXXXSvvvFFFXXXXXXXXXXXXXXXXXXXXXXXXXXXXXXXSvvvGGGXXXXXXXXXXXXXXXXXXXXXX
<<<<<<<<<<<<<<<<<<<<H++++++<<<<<<<<<<<<<<<<<<<<<<<<<<<<<<<J++++++<<<<<<<<<<<<<<<<<<<<<<
<<<<<<<<<<<<<<<<<<<<H++++++<<<<<<<<<<<<<<<<<<<<<<<<<<<<<<<J++++++<<<<<<<<<<<<<<<<<<<<<<
<<<<<<<<<<<<<<<<<<<<H++++++<<<<<<<<<<<<<<<<<<<<<<<<<<<<<<<J++++++<<<<<<<<<<<<<<<<<<<<<<
>>>>>>>>>>>>>>>>>>>>>++++++J>>>>>>>>>>>>>>>>>>>>>>>>>>>>>>>++++++L>>>>>>>>>>>>>>>>>>>>>
>>>>>>>>>>>>>>>>>>>>>++++++J>>>>>>>>>>>>>>>>>>>>>>>>>>>>>>>++++++L>>>>>>>>>>>>>>>>>>>>>
>>>>>>>>>>>>>>>>>>>>>++++++J>>>>>>>>>>>>>>>>>>>>>>>>>>>>>>>++++++L>>>>>>>>>>>>>>>>>>>>>
XXXXXXXXXXXXXXXXXXXXXIII^^^XXXXXXXXXXXXXXXXXXXXXXXXXXXXXXXXKKK^^^XXXXXXXXXXXXXXXXXXXXXX
XXXXXXXXXXXXXXXXXXXXXvvv^^^XXXXXXXXXXXXXXXXXXXXXXXXXXXXXXXXvvv^^^XXXXXXXXXXXXXXXXXXXXXX
XXXXXXXXXXXXXXXXXXXXXvvv^^^XXXXXXXXXXXXXXXXXXXXXXXXXXXXXXXXvvv^^^XXXXXXXXXXXXXXXXXXXXXX
XXXXXXXXXXXXXXXXXXXXXvvv^^^XXXXXXXXXXXXXXXXXXXXXXXXXXXXXXXXvvv^^^XXXXXXXXXXXXXXXXXXXXXX
XXXXXXXXXXXXXXXXXXXXXvvv^^^XXXXXXXXXXXXXXXXXXXXXXXXXXXXXXXXvvv^^^XXXXXXXXXXXXXXXXXXXXXX
XXXXXXXXXXXXXXXXXXXXXvvv^^^XXXXXXXXXXXXXXXXXXXXXXXXXXXXXXXXvvv^^^XXXXXXXXXXXXXXXXXXXXXX
XXXXXXXXXXXXXXXXXXXXXvvv^^^XXXXXXXXXXXXXXXXXXXXXXXXXXXXXXXXvvv^^^XXXXXXXXXXXXXXXXXXXXXX
XXXXXXXXXXXXXXXXXXXXXvvv^^^XXXXXXXXXXXXXXXXXXXXXXXXXXXXXXXXvvv^^^XXXXXXXXXXXXXXXXXXXXXX
XXXXXXXXXXXXXXXXXXXXXvvv^^^XXXXXXXXXXXXXXXXXXXXXXXXXXXXXXXXvvv^^^XXXXXXXXXXXXXXXXXXXXXX
XXXXXXXXXXXXXXXXXXXXXvvv^^^XXXXXXXXXXXXXXXXXXXXXXXXXXXXXXXXvvv^^^XXXXXXXXXXXXXXXXXXXXXX