◼◼◼◼◼◼◼◼◼◼◼◼◼◼◼◼◼◼◼◼◼vvv^^^◼◼◼◼◼◼◼◼◼◼◼◼◼◼◼◼◼◼◼◼◼◼◼◼◼◼◼◼◼◼◼◼vvv^^^◼◼◼◼◼◼◼◼◼◼◼◼◼◼◼◼◼◼◼◼◼◼
◼◼◼◼◼◼◼◼◼◼◼◼◼◼◼◼◼◼◼◼◼vvv^^^◼◼◼◼◼◼◼◼◼◼◼◼◼◼◼◼◼◼◼◼◼◼◼◼◼◼◼◼◼◼◼◼vvv^^^◼◼◼◼◼◼◼◼◼◼◼◼◼◼◼◼◼◼◼◼◼◼
◼◼◼◼◼◼◼◼◼◼◼◼◼◼◼◼◼◼◼◼◼vvv^^^◼◼◼◼◼◼◼◼◼◼◼◼◼◼◼◼◼◼◼◼◼◼◼◼◼◼◼◼◼◼◼◼vvv^^^◼◼◼◼◼◼◼◼◼◼◼◼◼◼◼◼◼◼◼◼◼◼
◼◼◼◼◼◼◼◼◼◼◼◼◼◼◼◼◼◼◼◼◼vvv^^^◼◼◼◼◼◼◼◼◼◼◼◼◼◼◼◼◼◼◼◼◼◼◼◼◼◼◼◼◼◼◼◼vvv^^^◼◼◼◼◼◼◼◼◼◼◼◼◼◼◼◼◼◼◼◼◼◼
◼◼◼◼◼◼◼◼◼◼◼◼◼◼◼◼◼◼◼◼◼vvv^^^◼◼◼◼◼◼◼◼◼◼◼◼◼◼◼◼◼◼◼◼◼◼◼◼◼◼◼◼◼◼◼◼vvv^^^◼◼◼◼◼◼◼◼◼◼◼◼◼◼◼◼◼◼◼◼◼◼
◼◼◼◼◼◼◼◼◼◼◼◼◼◼◼◼◼◼◼◼◼vvv^^^◼◼◼◼◼◼◼◼◼◼◼◼◼◼◼◼◼◼◼◼◼◼◼◼◼◼◼◼◼◼◼◼vvv^^^◼◼◼◼◼◼◼◼◼◼◼◼◼◼◼◼◼◼◼◼◼◼
◼◼◼◼◼◼◼◼◼◼◼◼◼◼◼◼◼◼◼◼◼vvv^^^◼◼◼◼◼◼◼◼◼◼◼◼◼◼◼◼◼◼◼◼◼◼◼◼◼◼◼◼◼◼◼◼vvv^^^◼◼◼◼◼◼◼◼◼◼◼◼◼◼◼◼◼◼◼◼◼◼
◼◼◼◼◼◼◼◼◼◼◼◼◼◼◼◼◼◼◼◼◼vvv^^^◼◼◼◼◼◼◼◼◼◼◼◼◼◼◼◼◼◼◼◼◼◼◼◼◼◼◼◼◼◼◼◼vvv^^^◼◼◼◼◼◼◼◼◼◼◼◼◼◼◼◼◼◼◼◼◼◼
◼◼◼◼◼◼◼◼◼◼◼◼◼◼◼◼◼◼◼◼◼vvv^^^◼◼◼◼◼◼◼◼◼◼◼◼◼◼◼◼◼◼◼◼◼◼◼◼◼◼◼◼◼◼◼◼vvv^^^◼◼◼◼◼◼◼◼◼◼◼◼◼◼◼◼◼◼◼◼◼◼
◼◼◼◼◼◼◼◼◼◼◼◼◼◼◼◼◼◼◼◼◼vvv^^^◼◼◼◼◼◼◼◼◼◼◼◼◼◼◼◼◼◼◼◼◼◼◼◼◼◼◼◼◼◼◼◼vvv^^^◼◼◼◼◼◼◼◼◼◼◼◼◼◼◼◼◼◼◼◼◼◼
<<<<<<<<<<<<<<<<<<<<<++++++<<<<<<<<<<<<<<<<<<<<<<<<<<<<<<<<++++++<<<<<<<<<<<<<<<<<<<<<<
<<<<<<<<<<<<<<<<<<<<<++++++<<<<<<<<<<<<<<<<<<<<<<<<<<<<<<<<++++++<<<<<<<<<<<<<<<<<<<<<<
<<<<<<<<<<<<<<<<<<<<<++++++<<<<<<<<<<<<<<<<<<<<<<<<<<<<<<<<++++++<<<<<<<<<<<<<<<<<<<<<<
>>>>>>>>>>>>>>>>>>>>>++++++>>>>>>>>>>>>>>>>>>>>>>>>>>>>>>>>++++++>>>>>>>>>>>>>>>>>>>>>>
>>>>>>>>>>>>>>>>>>>>>++++++>>>>>>>>>>>>>>>>>>>>>>>>>>>>>>>>++++++>>>>>>>>>>>>>>>>>>>>>>
>>>>>>>>>>>>>>>>>>>>>++++++>>>>>>>>>>>>>>>>>>>>>>>>>>>>>>>>++++++>>>>>>>>>>>>>>>>>>>>>>
◼◼◼◼◼◼◼◼◼◼◼◼◼◼◼◼◼◼◼◼◼vvv^^^◼◼◼◼◼◼◼◼◼◼◼◼◼◼◼◼◼◼◼◼◼◼◼◼◼◼◼◼◼◼◼◼vvv^^^◼◼◼◼◼◼◼◼◼◼◼◼◼◼◼◼◼◼◼◼◼◼
◼◼◼◼◼◼◼◼◼◼◼◼◼◼◼◼◼◼◼◼◼vvv^^^◼◼◼◼◼◼◼◼◼◼◼◼◼◼◼◼◼◼◼◼◼◼◼◼◼◼◼◼◼◼◼◼vvv^^^◼◼◼◼◼◼◼◼◼◼◼◼◼◼◼◼◼◼◼◼◼◼
◼◼◼◼◼◼◼◼◼◼◼◼◼◼◼◼◼◼◼◼◼vvv^^^◼◼◼◼◼◼◼◼◼◼◼◼◼◼◼◼◼◼◼◼◼◼◼◼◼◼◼◼◼◼◼◼vvv^^^◼◼◼◼◼◼◼◼◼◼◼◼◼◼◼◼◼◼◼◼◼◼
◼◼◼◼◼◼◼◼◼◼◼◼◼◼◼◼◼◼◼◼◼vvv^^^◼◼◼◼◼◼◼◼◼◼◼◼◼◼◼◼◼◼◼◼◼◼◼◼◼◼◼◼◼◼◼◼vvv^^^◼◼◼◼◼◼◼◼◼◼◼◼◼◼◼◼◼◼◼◼◼◼
◼◼◼◼◼◼◼◼◼◼◼◼◼◼◼◼◼◼◼◼◼vvv^^^◼◼◼◼◼◼◼◼◼◼◼◼◼◼◼◼◼◼◼◼◼◼◼◼◼◼◼◼◼◼◼◼vvv^^^◼◼◼◼◼◼◼◼◼◼◼◼◼◼◼◼◼◼◼◼◼◼
◼◼◼◼◼◼◼◼◼◼◼◼◼◼◼◼◼◼◼◼◼vvv^^^◼◼◼◼◼◼◼◼◼◼◼◼◼◼◼◼◼◼◼◼◼◼◼◼◼◼◼◼◼◼◼◼vvv^^^◼◼◼◼◼◼◼◼◼◼◼◼◼◼◼◼◼◼◼◼◼◼
◼◼◼◼◼◼◼◼◼◼◼◼◼◼◼◼◼◼◼◼◼vvv^^^◼◼◼◼◼◼◼◼◼◼◼◼◼◼◼◼◼◼◼◼◼◼◼◼◼◼◼◼◼◼◼◼vvv^^^◼◼◼◼◼◼◼◼◼◼◼◼◼◼◼◼◼◼◼◼◼◼
◼◼◼◼◼◼◼◼◼◼◼◼◼◼◼◼◼◼◼◼◼vvv^^^◼◼◼◼◼◼◼◼◼◼◼◼◼◼◼◼◼◼◼◼◼◼◼◼◼◼◼◼◼◼◼◼vvv^^^◼◼◼◼◼◼◼◼◼◼◼◼◼◼◼◼◼◼◼◼◼◼
◼◼◼◼◼◼◼◼◼◼◼◼◼◼◼◼◼◼◼◼◼vvv^^^◼◼◼◼◼◼◼◼◼◼◼◼◼◼◼◼◼◼◼◼◼◼◼◼◼◼◼◼◼◼◼◼vvv^^^◼◼◼◼◼◼◼◼◼◼◼◼◼◼◼◼◼◼◼◼◼◼
◼◼◼◼◼◼◼◼◼◼◼◼◼◼◼◼◼◼◼◼◼vvv^^^◼◼◼◼◼◼◼◼◼◼◼◼◼◼◼◼◼◼◼◼◼◼◼◼◼◼◼◼◼◼◼◼vvv^^^◼◼◼◼◼◼◼◼◼◼◼◼◼◼◼◼◼◼◼◼◼◼
<<<<<<<<<<<<<<<<<<<<<++++++<<<<<<<<<<<<<<<<<<<<<<<<<<<<<<<<++++++<<<<<<<<<<<<<<<<<<<<<<
<<<<<<<<<<<<<<<<<<<<<++++++<<<<<<<<<<<<<<<<<<<<<<<<<<<<<<<<++++++<<<<<<<<<<<<<<<<<<<<<<
<<<<<<<<<<<<<<<<<<<<<++++++<<<<<<<<<<<<<<<<<<<<<<<<<<<<<<<<++++++<<<<<<<<<<<<<<<<<<<<<<
>>>>>>>>>>>>>>>>>>>>>++++++>>>>>>>>>>>>>>>>>>>>>>>>>>>>>>>>++++++>>>>>>>>>>>>>>>>>>>>>>
>>>>>>>>>>>>>>>>>>>>>++++++>>>>>>>>>>>>>>>>>>>>>>>>>>>>>>>>++++++>>>>>>>>>>>>>>>>>>>>>>
>>>>>>>>>>>>>>>>>>>>>++++++>>>>>>>>>>>>>>>>>>>>>>>>>>>>>>>>++++++>>>>>>>>>>>>>>>>>>>>>>
◼◼◼◼◼◼◼◼◼◼◼◼◼◼◼◼◼◼◼◼◼vvv^^^◼◼◼◼◼◼◼◼◼◼◼◼◼◼◼◼◼◼◼◼◼◼◼◼◼◼◼◼◼◼◼◼vvv^^^◼◼◼◼◼◼◼◼◼◼◼◼◼◼◼◼◼◼◼◼◼◼
◼◼◼◼◼◼◼◼◼◼◼◼◼◼◼◼◼◼◼◼◼vvv^^^◼◼◼◼◼◼◼◼◼◼◼◼◼◼◼◼◼◼◼◼◼◼◼◼◼◼◼◼◼◼◼◼vvv^^^◼◼◼◼◼◼◼◼◼◼◼◼◼◼◼◼◼◼◼◼◼◼
◼◼◼◼◼◼◼◼◼◼◼◼◼◼◼◼◼◼◼◼◼vvv^^^◼◼◼◼◼◼◼◼◼◼◼◼◼◼◼◼◼◼◼◼◼◼◼◼◼◼◼◼◼◼◼◼vvv^^^◼◼◼◼◼◼◼◼◼◼◼◼◼◼◼◼◼◼◼◼◼◼
◼◼◼◼◼◼◼◼◼◼◼◼◼◼◼◼◼◼◼◼◼vvv^^^◼◼◼◼◼◼◼◼◼◼◼◼◼◼◼◼◼◼◼◼◼◼◼◼◼◼◼◼◼◼◼◼vvv^^^◼◼◼◼◼◼◼◼◼◼◼◼◼◼◼◼◼◼◼◼◼◼
◼◼◼◼◼◼◼◼◼◼◼◼◼◼◼◼◼◼◼◼◼vvv^^^◼◼◼◼◼◼◼◼◼◼◼◼◼◼◼◼◼◼◼◼◼◼◼◼◼◼◼◼◼◼◼◼vvv^^^◼◼◼◼◼◼◼◼◼◼◼◼◼◼◼◼◼◼◼◼◼◼
◼◼◼◼◼◼◼◼◼◼◼◼◼◼◼◼◼◼◼◼◼vvv^^^◼◼◼◼◼◼◼◼◼◼◼◼◼◼◼◼◼◼◼◼◼◼◼◼◼◼◼◼◼◼◼◼vvv^^^◼◼◼◼◼◼◼◼◼◼◼◼◼◼◼◼◼◼◼◼◼◼
◼◼◼◼◼◼◼◼◼◼◼◼◼◼◼◼◼◼◼◼◼vvv^^^◼◼◼◼◼◼◼◼◼◼◼◼◼◼◼◼◼◼◼◼◼◼◼◼◼◼◼◼◼◼◼◼vvv^^^◼◼◼◼◼◼◼◼◼◼◼◼◼◼◼◼◼◼◼◼◼◼
◼◼◼◼◼◼◼◼◼◼◼◼◼◼◼◼◼◼◼◼◼vvv^^^◼◼◼◼◼◼◼◼◼◼◼◼◼◼◼◼◼◼◼◼◼◼◼◼◼◼◼◼◼◼◼◼vvv^^^◼◼◼◼◼◼◼◼◼◼◼◼◼◼◼◼◼◼◼◼◼◼
◼◼◼◼◼◼◼◼◼◼◼◼◼◼◼◼◼◼◼◼◼vvv^^^◼◼◼◼◼◼◼◼◼◼◼◼◼◼◼◼◼◼◼◼◼◼◼◼◼◼◼◼◼◼◼◼vvv^^^◼◼◼◼◼◼◼◼◼◼◼◼◼◼◼◼◼◼◼◼◼◼
◼◼◼◼◼◼◼◼◼◼◼◼◼◼◼◼◼◼◼◼◼vvv^^^◼◼◼◼◼◼◼◼◼◼◼◼◼◼◼◼◼◼◼◼◼◼◼◼◼◼◼◼◼◼◼◼vvv^^^◼◼◼◼◼◼◼◼◼◼◼◼◼◼◼◼◼◼◼◼◼◼