XXXXXXXXXXXXXXXXXXXXX||||||XXXXXXXXXXXXXXXXXXXXXXXXXXXXXXXX||||||XXXXXXXXXXXXXXXXXXXXXX
XXXXXXXXXXXXXXXXXXXXX||||||XXXXXXXXXXXXXXXXXXXXXXXXXXXXXXXX||||||XXXXXXXXXXXXXXXXXXXXXX
XXXXXXXXXXXXXXXXXXXXX||||||XXXXXXXXXXXXXXXXXXXXXXXXXXXXXXXX||||||XXXXXXXXXXXXXXXXXXXXXX
XXXXXXXXXXXXXXXXXXXXX||||||XXXXXXXXXXXXXXXXXXXXXXXXXXXXXXXX||||||XXXXXXXXXXXXXXXXXXXXXX
XXXXXXXXXXXXXXXXXXXXX||||||XXXXXXXXXXXXXXXXXXXXXXXXXXXXXXXX||||||XXXXXXXXXXXXXXXXXXXXXX
XXXXXXXXXXXXXXXXXXXXX||||||XXXXXXXXXXXXXXXXXXXXXXXXXXXXXXXX||||||XXXXXXXXXXXXXXXXXXXXXX
XXXXXXXXXXXXXXXXXXXXX||||||XXXXXXXXXXXXXXXXXXXXXXXXXXXXXXXX||||||XXXXXXXXXXXXXXXXXXXXXX
XXXXXXXXXXXXXXXXXXXXX||||||XXXXXXXXXXXXXXXXXXXXXXXXXXXXXXXX||||||XXXXXXXXXXXXXXXXXXXXXX
XXXXXXXXXXXXXXXXXXXXX||||||XXXXXXXXXXXXXXXXXXXXXXXXXXXXXXXX||||||XXXXXXXXXXXXXXXXXXXXXX
XXXXXXXXXXXXXXXXXXXXX||||||XXXXXXXXXXXXXXXXXXXXXXXXXXXXXXXX<v>^^^XXXXXXXXXXXXXXXXXXXXXX
---------------------++++++--------------------------------+SS+++^---------------------
---------------------++++++--------------------------------+++++S<---------------------
---------------------++++++--------------------------------+++++Sv---------------------
---------------------++++++-------------------------------^S+++++----------------------
---------------------++++++------------------------------->S+++++----------------------
---------------------++++++-------------------------------v+++SS+----------------------
XXXXXXXXXXXXXXXXXXXXX||||||XXXXXXXXXXXXXXXXXXXXXXXXXXXXXXXXvvv<^>XXXXXXXXXXXXXXXXXXXXXX
XXXXXXXXXXXXXXXXXXXXX||||||XXXXXXXXXXXXXXXXXXXXXXXXXXXXXXXX||||||XXXXXXXXXXXXXXXXXXXXXX
XXXXXXXXXXXXXXXXXXXXX||||||XXXXXXXXXXXXXXXXXXXXXXXXXXXXXXXX||||||XXXXXXXXXXXXXXXXXXXXXX
XXXXXXXXXXXXXXXXXXXXX||||||XXXXXXXXXXXXXXXXXXXXXXXXXXXXXXXX||||||XXXXXXXXXXXXXXXXXXXXXX
XXXXXXXXXXXXXXXXXXXXX||||||XXXXXXXXXXXXXXXXXXXXXXXXXXXXXXXX||||||XXXXXXXXXXXXXXXXXXXXXX
XXXXXXXXXXXXXXXXXXXXX||||||XXXXXXXXXXXXXXXXXXXXXXXXXXXXXXXX||||||XXXXXXXXXXXXXXXXXXXXXX
XXXXXXXXXXXXXXXXXXXXX||||||XXXXXXXXXXXXXXXXXXXXXXXXXXXXXXXX||||||XXXXXXXXXXXXXXXXXXXXXX
XXXXXXXXXXXXXXXXXXXXX||||||XXXXXXXXXXXXXXXXXXXXXXXXXXXXXXXX||||||XXXXXXXXXXXXXXXXXXXXXX
XXXXXXXXXXXXXXXXXXXXX||||||XXXXXXXXXXXXXXXXXXXXXXXXXXXXXXXX||||||XXXXXXXXXXXXXXXXXXXXXX
XXXXXXXXXXXXXXXXXXXXX||||||XXXXXXXXXXXXXXXXXXXXXXXXXXXXXXXX||||||XXXXXXXXXXXXXXXXXXXXXX
---------------------++++++--------------------------------++++++----------------------
---------------------++++++--------------------------------++++++----------------------
---------------------++++++--------------------------------++++++----------------------
---------------------++++++--------------------------------++++++----------------------
---------------------++++++--------------------------------++++++----------------------
---------------------++++++--------------------------------++++++----------------------
XXXXXXXXXXXXXXXXXXXXX||||||XXXXXXXXXXXXXXXXXXXXXXXXXXXXXXXX||||||XXXXXXXXXXXXXXXXXXXXXX
XXXXXXXXXXXXXXXXXXXXX||||||XXXXXXXXXXXXXXXXXXXXXXXXXXXXXXXX||||||XXXXXXXXXXXXXXXXXXXXXX
XXXXXXXXXXXXXXXXXXXXX||||||XXXXXXXXXXXXXXXXXXXXXXXXXXXXXXXX||||||XXXXXXXXXXXXXXXXXXXXXX
XXXXXXXXXXXXXXXXXXXXX||||||XXXXXXXXXXXXXXXXXXXXXXXXXXXXXXXX||||||XXXXXXXXXXXXXXXXXXXXXX
XXXXXXXXXXXXXXXXXXXXX||||||XXXXXXXXXXXXXXXXXXXXXXXXXXXXXXXX||||||XXXXXXXXXXXXXXXXXXXXXX
XXXXXXXXXXXXXXXXXXXXX||||||XXXXXXXXXXXXXXXXXXXXXXXXXXXXXXXX||||||XXXXXXXXXXXXXXXXXXXXXX
XXXXXXXXXXXXXXXXXXXXX||||||XXXXXXXXXXXXXXXXXXXXXXXXXXXXXXXX||||||XXXXXXXXXXXXXXXXXXXXXX
XXXXXXXXXXXXXXXXXXXXX||||||XXXXXXXXXXXXXXXXXXXXXXXXXXXXXXXX||||||XXXXXXXXXXXXXXXXXXXXXX
XXXXXXXXXXXXXXXXXXXXX||||||XXXXXXXXXXXXXXXXXXXXXXXXXXXXXXXX||||||XXXXXXXXXXXXXXXXXXXXXX
XXXXXXXXXXXXXXXXXXXXX||||||XXXXXXXXXXXXXXXXXXXXXXXXXXXXXXXX||||||XXXXXXXXXXXXXXXXXXXXXX